11111111111111111111111111111
11110C00000000000000000001111
11100000111110111110000000001
100E000000C000000000C0000P111
11100000111110111110000000001
11110C00000000000000000001111
11111111111111111111111111111
